- puranji zrezek 			Putenschnitzel
- zelenjavna juha 			- Gemüsesuppe
bati se, boji se 	Verb, impf 		sich fürchten
dober -bra, -o 	Adjektiv 		gut
doma 	Adverb 		zu Hause
faks-a 	Substantiv 	m 	Fakultät (umgangssprachlich)
hudo-ega 	Substantiv 	n 	Übel
iti, gre 	Verb, impf/pf 		gehen
joj 	Interjektion 		oh
juha-e 	Substantiv 	f 	Suppe
kaj, česa 	Indefinitpronomen 		(et)was
krompir-ja 	Substantiv 	m/Sg 	Kartoffel
kuhinja-e 	Substantiv 	f 	Küche
lahko 	Modalwort / Prädikativ 		können, kann
ne imeti, nima 	Verb, impf 		nicht haben
nič hudega! 			macht nichts!
nič, ničesar 	Indefinitpronomen 		nichts
obisk-a 	Substantiv 	m 	Besuch
odpreti-e 	Verb, pf 		öffnen
omara-e 	Substantiv 	f 	Schrank
polica-e 	Substantiv 	f 	Regal
potem 	Adverb 		danach
prav 	Adverb 		in Ordnung
punca-e 	Substantiv 	f 	Mädchen, Mädel - umgangssprachlich
puranji -a, -e 	Adjektiv 		Truthahn
recept-a 	Substantiv 	m 	Rezept
riž-a 	Substantiv 	m/Sg 	Reis
samo 	Adverb 		nur
skuhati -am 	Verb, pf 		(fertig) kochen
smetana-e 	Substantiv 	f/Sg 	Sahne
soba-e 	Substantiv 	f 	Zimmer
speči, speče 	Verb, pf 		(fertig) backen
starši-šev 	Substantiv 	m/Pl 	Eltern
škoda-e 	Substantiv 	f 	Schade
štirje, štiri 	Numerale 		vier
teta-e 	Substantiv 	f 	Tante
tudi 	Adverb 		auch
tukaj 	Adverb 		hier
večerja-e 	Substantiv 	f 	Abendessen
vedno 	Adverb 		immer
veseliti se, veselí se 	Verb, imp 		sich freuen
vrata-ø 	Substantiv 	n/Pl 	Tür
zelenjaven-vna, -o 	Adjektiv 		Gemüse-
zrezek-zka 	Substantiv 	m 	Schnitzel
zvoniti-i 	Verb, impf 		klingeln