- od kod? 			- woher?
- pesniška zbirka 			- Gedichtsammlung ,Gedichtband
abecednik (-a) 	Substantiv, m 		Fibel (erstes Lesebuch)
avtor (-ja) 	Substantiv, m 		Author
biblija (-e) 	Substantiv, f 		Bibel
brati, bere 	Verb, impf 		lesen
Cukrarna (-e) 	Substantiv, f 		ehemalige Zuckerfabrik in Ljubljana
črtica (-e) 	Substantiv, f 		Kurzgeschichte
danes 	Adverb 		heute
december (-bra) 	Substantiv, m 		Dezember
delo (-a) 	Substantiv, n 		Arbeit, Werk
do 	Präposition, Gen. 		bis
Dolenjska (-e) 	Substantiv, f 		Landschaft südlich von Ljubljana
družina (-e) 	Substantiv, f 		Familie
februar (-ja) 	Substantiv, m 		Februar
Gorenjska (-e) 	Substantiv, f 		Landschaft nordwestlich von Ljubljana
Gradec (-dca) 	Substantiv, m 		slowenischer Name für Graz
imenovati se, imenujem se 	Verb, impf 		sich nennen
izdati, -a 	Verb, pf 		herausgeben
izvirati, -a 	Verb, impf 		stammen
jezik (-a) 	Substantiv, m 		Sprache
kakšen, -šna, -o 	Interrogativpronomen 		was für ein/eine/ein, wie
kdaj 	Interrogativpronomen 		wann
knjiga (-e) 	Substantiv, f 		Buch
korenina (-e) 	Substantiv, f 		Wurzel
kultura (-e) 	Substantiv, f 		Kultur
leto (-a) 	Substantiv, n 		Jahr
mati, matere 	Substantiv, f 		Mutter
moderna (-e) 	Substantiv, f 		Moderne
moj, -a, -e 	Possesivpronomen 		mein, meine, mein
napisati, napišem 	Verb, pf 		schreiben
naslov (-a) 	Substantiv, m 		Titel
nemščina (-e) 	Substantiv, f 		deutsche Sprache
njegov, -a, -o 	Possesivpronomen 		sein, seine, sein
njen, -a, -o 	Possesivpronomen 		ihr, ihre, ihre
od 	Präposition, Gen. 		von
pesem (-smi) 	Substantiv, f 		Gedicht
pesniški, -a, -o 	Adjektiv 		Gedicht-
pisati, pišem 	Verb, impf 		schreiben
pismo (-a) 	Substantiv, n 		Brief
plemiški, -a, -o 	Adjektiv 		adelig
poezija (-e) 	Substantiv, f 		Dichtung
poznati, -a 	Verb, impf 		kennen
pozneje 	Adverb 		später
praznik (-a) 	Substantiv, m 		Feiertag
predstavljati si, -a si 	Verb, impf 		sich vorstellen
predstavnik (-a) 	Substantiv, m 		Vertreter
prevajati, -a 	Verb, impf 		übersetzen
prevesti, prevede 	Verb, pf 		übersetzen
prevod (-a) 	Substantiv, m 		Übersetzung
proza (-e) 	Substantiv, f 		Prosa
roditi se, -i se 	Verb, impf/pf 		geboren werden
seveda 	Adverb 		natürlich
slovenski, -a, -o 	Adjektiv 		slowenisch
slovenščina (-e) 	Substantiv, f 		slowenische Sprache
spomniti se, -i se 	Verb, pf 		sich erinnern
Sveto pismo (-ega -a) 	Substantiv, n 		Heilige Schrift
umreti, -e 	Verb, pf 		sterben
veliko 	Adverb 		viel
vsi, vseh / vse, vseh 	Pronomen 		alle
začetek (-tka) 	Substantiv, m 		Anfang
zakaj 	Fragepronomen 		Warum
zanimivo 	Adverb 		interessant
zbirka (-e) 	Substantiv, f 		Sammlung
znati, -a 	Verb, impf 		können
živeti, živi 	Verb, impf 		leben
življenje (-a) 	Substantiv, n 		Leben