- filozófska fakultéta 			Philosophische Fakultät
- Kongrésni tŕg 			- Kongressplatz
- méstna híša 			- Rathaus
- Modêrna galeríja 			- Galerie für die zeitgenössische Kunst
- na désni 			- rechts
- na lévi 			- links
- Národna galeríja 			- Nationalgalerie
- Stári tŕg 			- Altmarkt
- tàm zádaj 			dahinten
bár (-a) 	Substantiv 	m 	Bar
bél -a, -o 	Adjektiv 		weiß
béž (auch beige)(unveränderlich) 	Adjektiv 		beige
čigáv -a, -o 	Interrogativpronom 		wessen
dêbel debéla, -o 	Adjektiv 		dick
désna (-e) 	Substantiv 	f 	rechte Seite
filozófski -a, -o 	Adjektiv 		philosophisch
híša (-e) 	Substantiv 	f 	Haus
jòj 	Interjektion 		oh
káj, čésa 	Fragepronomen 		was
kakó 	Fragepronomen 		wie
kákšen -šna, -o 	Interrogativpronom 		wie, was für ein
kitájski -a, -o 	Adjektiv 		chinesisch
knjíga (-e) 	Substantiv 	f 	Buch
lép -a, -o 	Adjektiv 		schön
léva (-e) 	Substantiv 	f 	linke Seite
líla (unveränderlich) 	Adjektiv 		lila
májhen -hna, -o 	Adjektiv 		klein
méstni -a, -o 	Adjektiv 		Stadt-
mésto (-a) 	Substantiv 	n 	Stadt
míza (-e) 	Substantiv 	f 	Tisch
móder -dra, -o 	Adjektiv 		blau
modêren -rna, -o 	Adjektiv 		modern
mój, môja , -e 	Possessivpronomen 		mein
národen -dna, -o 	Adjektiv 		national
nòv, nôva, -o 	Adjektiv 		neu
odpŕt, -a, -o 	Adjektiv 		offen, geöffnet
ôkno (-a) 	Substantiv 	n 	Fenster
omára (-e) 	Substantiv 	f 	Schrank
pésnik (-a) 	Substantiv 	m 	Dichter
pocéni (unveränderlich) 	Adjektiv 		billig, preiswert
políca (-e) 	Substantiv 	f 	Regal
prázen -zna, -o 	Adjektiv 		leer
prostóren -rna, -o 	Adjektiv 		geräumig
rdèč, rdéča, -e 	Adjektiv 		rot
réka (-e) 	Substantiv 	f 	Fluss
restavrácija (-e) 	Substantiv 	f 	Restaurant
rjàv, rjáva, -o 	Adjektiv 		braun
róza (unveränderlich) 	Adjektiv 		rosa
róža (-e) 	Substantiv 	f 	Blume
rumèn, rumêna, -o 	Adjektiv 		gelb
samó 	Adverb 		nur
sív -a, -o 	Adjektiv 		grau
sôba (-e) 	Substantiv 	f 	Zimmer
stanovánje (-a) 	Substantiv 	n 	Wohnung
stàr, stára, -o 	Adjektiv 		alt
stávba (-e) 	Substantiv 	f 	Gebäude
stòl (-a) 	Substantiv 	m 	Stuhl
tŕg (-a) 	Substantiv 	m 	Platz, Markt
tá, tá, tó 	Demonstrativpronomen 		das
tàm 	Adverb 		dort
tánek -nka, -o 	Adjektiv 		dünn
tvój, tvôja, -e 	Possessivpronomen 		dein
vêlik, velíka, -o 	Adjektiv 		groß
zádaj 	Adverb 		hinten
zelèn, zelêna, -o 	Adjektiv 		grün
zgôraj 	Adverb 		oben