- raje, najraje 			- lieber, am liebsten
àmpak 	Konjunktion 		aber, sondern
bráti, bêre 	Verb, impf 		lesen
dán (dnéva) 	Substantiv 	m 	Tag
délati, -a 	Verb, impf 		machen
dopôldne 	Adverb 		vormittags
ín 	Konjunktion 		und
kolesáriti, -i 	Verb, impf 		Rad fahren
kòt 	Konjunktion 		als
nájprej 	Adverb 		zuerst
natákarica (-e) 	Substantiv 	f 	Kellnerin
obléči se, obléče se 	Verb, pf 		sich anziehen
pisáti, píše 	Verb, impf 		schreiben
plesáti, pléše 	Verb, impf 		tanzen
pogovárjati se, -a se 	Verb, impf 		sich unterhalten
popôldne 	Adverb 		nachmittags
potem 	Adverb 		dann
rad -a, -o 	Adverb 		gern
slikati, -a 	Verb, impf 		malen
smučati, -a 	Verb, impf 		Ski fahren
stuširati se, -a se 	Verb, pf 		duschen
študirati, -a 	Verb, impf 		studieren
telovaditi, -i 	Verb, impf 		turnen
tudi 	Konjunktion 		auch
vsak -a, -o 	Adjektiv 		jeder
vstati, vstane 	Verb, pf 		aufstehen, sich erheben
zabavati se, -a se 	Verb, impf 		sich unterhalten, sich vergnügen
zajtrk (-a) 	Substantiv 	m 	Frühstück
zajtrkovati, zajtrkuje 	Verb, impf 		frühstücken
zjutraj 	Adverb 		morgens, am Morgen
znati, zna 	Verb, impf 		können
zvečer 	Adverb 		abends, am Abend