avtobusna postaja 			Bushaltestelle, Busbahnhof
avtobusni, -a, -o 	Adjektiv 		Bus- (in Komposita)
da 	Konjunktion 		dass
dan (dneva) 	Substantiv 	m 	Tag
danes 	Adverb 		heute
darilo (-a) 	Substantiv 	n 	Geschenk
dati, da 	Verb, pf 		geben
dobro 	Adverb 		gut
družina (-e) 	Substantiv 	f 	Familie
hčerka (-e) 	Substantiv 	f 	Tochter
iti, gre
iti iskat 	Verb, pf / impf 		gehen
holen
lepo 	Adverb 		schön
misliti, -i 	Verb, impf 		denken
mož (-a) 	Substantiv 	m 	Ehemann
na 	Präposition +Akk 		auf, an
oče (-eta) 	Substantiv 	m 	Vater
obiskati, obišče (+Akk.) 	Verb, pf 		besuchen
otrok (-a) 	Substantiv 	m 	Kind
pisati, piše 	Verb, impf 		schreiben
poklicati, -kliče 	Verb, pf 		anrufen
postaja (-e) 	Substantiv 	f 	Haltestelle
povabiti, -i 	Verb, pf 		einladen
pozabiti, -i 	Verb, pf 		vergessen
poznati, -zna 	Verb, impf 		kennen
praviti, -i 	Verb, impf / pf 		sagen
prijatelj (-a) 	Substantiv 	m 	Freund
priti, pride 	Verb, pf 		kommen
rojstni, -a,-o 	Adjektiv 		Geburts-
rojstni dan 			Geburtstag
seveda 	Adverb 		natürlich
sin (-a) (Pl. sinovi) 	Substantiv 	m 	Sohn
slabo 	Adverb 		schlecht
spomniti, -i (na+Akk) 	Verb, pf 		erinnern an
spraševati, -šuje 	Verb, impf 		fragen
stari starši 			Großeltern
starši (-ev) 	Substantiv 	m, Pl. 	Eltern
vabilo (-a) 	Substantiv 	n 	Einladung
vaza (-e) 	Substantiv 	f 	Vase
vedno 	Adverb 		immer
vesel, -a,-o 	Adjektiv 		froh
vrtnica (-e) 	Substantiv 	f 	Rose
vsi 	Pronom 		alle
za 	Präposition (+Akk) 		für, hinter
zabava (-e) 	Substantiv 	f 	Fest, Party
zahvaliti se, -i se 	Verb, pf 		danken
žena (-e) 	Substantiv 	f 	Ehefrau